 #########.
   #    # #
   #*   ###
    **    #
 .   .... #
# #########
          #
########## 