1        #.         #
   #    # #         #
   #*   ###  R     ##
    **    #          
 .   ....            
                     
 .   ....       R    
#####################